tel_pair 6 8 10 6
#
NNNNNFNNGNNN
NNNNNNNFFNNN
NNNNNNNNNNNN
NNNNNNTFNNNN
NNNNNNNNNNNN
ENNNBFFNNNTN
NNNNNPNNNNNN
NNNNNNNNNNNN
NNNNNNNNNNNN
NNNNNNNNNNNN
NNNNNNNNNNNE
NNNNNNNNNNNN